13 13
#############
#...........#
#.##.###.##.#
#..#..#..#..#
#..#.....#..#
#..#..#..#..#
#.#########.#
#..#..#..#..#
#..#.....#..#
#..#..#..#..#
#.##.###.##.#
#...........#
#############
1 1 2 1 3 1
6
Food 2
Teleport 4